  ## #####
       # #
 ## ## ## 
 # # #   #
  #  #   #
  #      #
# ########
# # ###  #
         #
# #  #    
